# VERSION
V 0.2.5
# GOALS
G 1 5309855068505147025 300
G 1 9824093894361502513 0
G 0 10899834782554881582 20000
G 0 8180831592100055012 1000
# MAP
RC 60 60
SE 5
SM 5
SB 1
SD 3
SV 4
--1--
5 5 5 7 2 1 1 1 1 20 20 20 0 0 0 0 0 0 2 1 1 1 1 2 0 0 0 0 0 0 0 0 0 0 0 20 20 20 20 0 0 0 0 0 2 1 2 0 0 0 0 0 0 0 0 0 0 0 0 0
5 5 7 7 2 1 2 2 20 3 3 20 0 0 0 0 0 0 2 2 2 2 2 2 0 0 0 0 0 0 0 0 0 0 0 20 3 3 20 0 0 0 0 0 2 1 2 0 0 0 0 0 0 0 0 0 0 0 0 0
5 7 7 0 2 1 2 0 20 3 3 20 0 0 0 0 0 0 0 0 0 0 0 0 0 0 0 0 0 0 0 0 0 0 0 20 3 3 20 0 0 0 0 0 2 2 2 0 0 0 0 0 0 0 0 0 0 0 0 0
7 7 0 0 2 1 2 0 20 20 20 20 0 0 0 0 0 0 0 0 0 0 0 0 0 0 0 0 0 0 0 0 0 0 0 20 20 20 20 0 0 0 0 0 0 0 0 0 0 0 0 0 0 0 0 0 0 0 0 0
0 0 0 0 2 2 2 0 0 0 0 0 0 0 0 2 2 2 2 2 2 20 20 20 20 0 0 0 0 0 0 0 0 0 0 2 2 2 2 0 0 0 0 0 0 0 0 0 0 0 0 0 0 0 0 0 0 0 0 0
0 0 0 0 0 0 2 2 2 0 2 2 2 0 3 3 1 1 1 1 2 20 3 3 20 0 0 0 0 0 0 0 0 0 0 2 1 1 2 0 0 0 0 0 20 20 20 20 0 0 0 0 0 0 0 0 0 0 0 0
20 20 20 20 0 0 2 1 2 0 2 1 2 0 20 3 3 20 2 1 2 20 3 3 20 0 0 0 0 0 0 0 0 0 0 2 1 2 2 2 2 2 0 0 20 3 3 20 0 0 0 0 0 0 0 0 0 0 0 0
20 3 3 20 2 2 2 1 6 6 6 1 2 2 20 3 3 20 2 1 2 20 20 20 20 0 0 0 2 2 2 0 0 0 0 2 2 2 7 7 1 2 0 0 20 3 3 20 0 0 0 0 0 0 0 0 0 0 0 0
20 3 3 20 2 1 1 1 6 4 6 1 1 1 20 20 20 20 2 1 2 0 0 0 0 0 0 0 2 1 2 0 0 0 0 0 0 0 7 5 1 2 0 0 20 20 20 20 0 2 2 2 0 0 0 0 0 0 0 0
20 20 20 20 2 2 2 6 4 4 4 6 2 2 2 0 0 0 2 1 2 0 0 0 0 0 2 2 2 1 2 2 2 0 0 0 0 0 7 5 1 2 0 0 0 0 0 0 0 2 1 2 0 0 0 20 20 20 20 0
2 2 0 0 2 1 1 1 6 4 6 1 1 1 2 0 0 0 2 1 2 0 0 0 0 0 2 1 1 1 1 1 2 0 0 0 0 0 7 5 1 2 0 0 0 0 0 0 0 2 1 2 0 0 0 20 3 3 20 0
1 2 0 0 2 2 2 1 6 6 6 1 2 2 2 0 0 0 2 1 2 0 0 0 0 0 2 2 2 2 2 2 2 0 0 0 0 0 7 5 1 2 20 20 20 20 0 0 2 2 1 2 0 0 0 20 3 3 20 0
1 2 0 0 0 0 2 1 2 0 2 1 2 0 0 0 0 0 2 2 2 0 0 0 0 0 0 0 0 0 0 0 0 0 2 2 2 0 7 7 1 2 20 3 3 20 0 0 2 1 1 2 0 0 0 20 20 20 20 0
1 2 2 2 2 0 2 2 2 0 2 2 2 0 0 0 0 0 0 0 0 0 0 0 0 0 0 0 20 20 20 20 0 0 2 1 2 0 0 2 2 2 20 3 3 20 0 0 2 2 2 2 0 0 0 0 0 0 0 0
1 1 1 1 2 0 0 0 0 0 0 0 0 0 0 0 0 0 0 0 0 0 0 0 0 0 0 0 20 3 3 20 0 0 2 1 2 0 0 0 0 0 20 20 20 20 0 0 0 0 0 0 0 0 0 0 0 0 0 0
2 2 2 2 2 0 0 0 0 0 0 0 0 2 2 2 0 0 0 0 0 0 0 0 0 0 0 0 20 3 3 20 0 0 2 1 2 0 0 0 0 0 0 0 0 0 0 0 0 0 0 0 0 0 0 0 0 0 0 0
0 0 0 0 0 0 0 20 20 20 20 0 0 2 1 2 0 0 7 7 7 2 0 2 2 2 0 0 20 20 20 20 0 0 2 1 2 0 0 0 0 0 0 0 0 0 0 0 20 20 20 20 0 0 0 0 0 0 6 6
0 0 0 0 0 0 0 20 3 3 20 0 0 2 1 2 0 7 7 5 1 2 0 2 1 2 0 0 0 0 0 0 0 0 2 2 2 0 0 0 0 0 0 0 0 0 0 0 20 3 3 20 0 0 0 0 0 0 6 4
0 0 0 0 0 0 0 20 3 3 20 2 2 2 1 2 7 7 5 5 1 2 0 2 1 6 6 0 0 0 0 0 0 0 0 0 0 0 0 0 0 0 0 0 0 0 0 0 20 3 3 20 0 0 0 0 0 0 6 4
0 0 0 0 0 0 0 20 20 20 20 1 1 1 1 2 7 5 5 5 1 2 0 2 1 4 6 6 0 0 0 0 0 0 0 0 0 0 0 0 0 0 0 0 0 0 0 0 20 20 20 20 0 0 0 0 0 0 6 4
0 0 0 0 0 0 0 0 0 0 2 2 2 2 2 2 7 1 1 1 1 2 0 2 1 4 4 6 2 2 0 0 0 0 0 0 0 0 0 0 0 0 0 0 0 0 0 0 0 0 0 0 0 0 0 0 0 0 6 6
0 2 2 2 0 0 0 0 0 0 0 0 0 0 0 0 20 20 20 20 1 2 0 2 1 1 1 1 1 2 0 0 0 0 2 2 2 0 0 0 0 0 0 2 2 2 0 0 0 0 0 0 0 0 0 0 0 0 0 0
0 2 1 2 0 0 0 0 0 0 0 0 0 0 0 0 20 3 3 20 1 2 0 2 1 20 20 20 20 2 0 0 0 0 2 1 2 0 0 0 0 0 0 2 1 2 0 0 0 0 0 0 0 0 0 0 0 0 0 0
0 2 1 2 0 7 7 7 2 0 0 0 0 0 0 0 20 3 3 20 1 2 0 2 1 20 3 3 20 0 0 0 2 2 2 1 2 0 0 0 0 0 0 2 1 2 2 2 2 2 0 0 0 0 0 0 0 0 0 0
0 2 1 2 0 7 5 1 2 0 0 0 0 0 0 0 20 20 20 20 2 2 0 2 1 20 3 3 20 0 0 0 2 1 1 1 2 0 0 0 0 0 0 2 1 1 1 1 1 2 0 0 0 0 0 0 0 0 0 0
0 2 1 2 0 7 5 1 2 0 0 0 0 0 0 0 0 0 0 0 0 0 0 2 1 20 20 20 20 2 0 0 7 5 5 1 2 0 0 0 0 0 0 2 2 2 2 2 1 2 2 2 2 2 2 2 2 2 0 0
0 2 1 2 0 7 5 1 2 0 0 20 20 20 20 0 0 0 0 0 0 0 0 2 2 2 0 2 1 2 0 0 7 7 5 1 2 0 0 0 0 0 0 0 0 0 0 2 1 1 1 1 1 1 1 1 1 2 0 0
0 2 1 2 0 7 5 1 2 0 0 20 3 3 20 0 0 0 2 2 2 0 0 0 0 0 0 2 1 2 0 0 0 7 7 2 2 0 0 0 0 0 0 0 0 0 0 2 2 2 2 2 2 2 2 2 2 2 0 0
0 2 1 2 0 7 5 1 2 0 0 20 3 3 20 0 0 0 2 1 2 0 0 0 0 0 0 2 1 2 0 0 0 0 0 0 0 0 0 0 2 2 2 0 0 0 0 0 0 0 0 0 0 0 0 0 0 0 0 0
0 2 1 2 0 7 5 1 2 2 2 20 20 20 20 0 0 0 2 1 2 0 0 0 0 0 0 2 2 2 0 0 0 0 0 0 0 0 0 0 2 1 2 0 0 0 0 0 0 0 0 0 0 0 0 0 0 0 0 0
0 2 1 2 0 7 5 1 1 1 1 1 1 2 0 0 0 0 2 2 2 0 0 0 2 2 2 2 2 2 0 0 0 0 20 20 20 20 0 0 2 1 2 0 0 0 0 0 0 0 0 0 0 0 20 20 20 20 0 0
0 2 1 2 0 7 7 7 2 2 2 2 2 2 0 0 0 0 0 0 0 0 0 0 2 1 1 1 1 2 0 0 0 0 20 3 3 20 0 0 2 1 2 0 0 0 0 0 0 0 0 0 0 0 20 3 3 20 0 0
0 2 1 2 2 2 0 0 0 0 0 0 0 0 0 0 0 0 0 0 0 0 0 20 20 20 20 2 1 2 0 0 0 0 20 3 3 20 0 0 2 1 2 0 0 0 0 0 0 0 0 0 0 0 20 3 3 20 0 0
0 2 1 1 1 2 0 0 0 0 0 0 0 0 0 0 0 0 0 0 0 0 0 20 3 3 20 2 1 2 0 0 0 0 20 20 20 20 0 0 2 1 2 0 0 0 0 0 0 2 2 2 0 0 20 20 20 20 0 0
0 2 2 2 1 2 0 0 0 0 0 0 0 0 0 0 0 0 0 0 0 0 0 20 3 3 20 2 1 2 0 0 0 0 0 0 0 0 0 0 2 2 2 0 0 0 0 7 7 2 1 2 0 0 0 0 0 0 0 0
0 0 0 2 1 2 0 20 20 20 20 0 0 0 0 0 0 0 0 0 0 0 0 20 20 20 20 2 2 2 0 0 2 2 2 0 0 0 0 0 0 0 0 0 0 0 7 7 5 2 1 2 0 0 0 0 0 0 0 0
0 0 0 2 1 2 0 20 3 3 20 0 0 0 0 0 0 0 0 0 0 0 0 0 0 0 0 0 0 0 0 2 2 1 2 0 0 0 0 0 0 0 0 0 0 0 7 5 5 2 1 2 0 0 0 0 0 0 0 0
0 0 0 2 2 2 0 20 3 3 20 0 0 2 2 2 2 2 2 2 2 0 0 0 0 0 0 0 0 0 0 2 1 1 2 0 0 0 0 0 0 0 0 0 0 0 2 2 2 2 1 2 2 2 2 0 0 0 0 0
0 0 0 0 0 0 0 20 20 20 20 0 0 2 1 1 1 1 1 1 2 0 0 0 0 0 0 0 0 0 0 2 2 2 2 0 0 0 0 0 0 0 0 0 0 0 2 1 1 1 1 1 1 1 2 0 0 0 0 0
0 0 0 0 0 0 0 0 0 0 0 0 0 2 2 2 2 2 2 2 2 0 0 0 0 0 0 0 0 0 0 0 20 20 20 20 0 0 0 0 0 0 0 0 0 0 2 2 2 2 1 2 2 2 2 0 0 0 0 0
0 0 0 0 0 0 0 0 0 0 0 0 0 0 0 0 0 0 0 0 0 0 0 0 0 0 0 0 0 0 0 0 20 3 3 20 0 0 0 0 0 0 0 0 0 0 0 0 0 2 1 2 0 0 0 0 0 0 0 0
0 0 0 0 0 0 0 0 0 0 0 0 0 0 0 0 0 20 20 20 20 0 0 0 0 0 0 0 0 0 0 0 20 3 3 20 0 0 2 2 2 2 0 0 0 0 0 0 0 2 1 2 0 0 0 0 0 0 0 0
0 0 0 0 0 7 7 7 7 2 0 0 0 0 0 0 0 20 3 3 20 0 0 0 0 0 0 0 0 0 0 0 20 20 20 20 0 0 2 1 1 2 0 0 0 0 0 0 0 2 1 2 0 0 0 0 0 0 0 0
0 0 0 0 0 7 5 5 1 2 0 0 0 0 0 0 0 20 3 3 20 0 0 0 0 0 0 0 0 0 0 0 0 0 0 0 0 0 2 2 1 2 0 0 0 0 0 0 0 2 2 2 0 0 0 0 0 0 0 0
0 0 0 0 0 7 5 5 1 2 0 0 0 0 0 0 0 20 20 20 20 0 0 0 0 0 0 0 0 0 0 0 0 0 0 0 0 0 0 2 1 2 0 0 0 0 0 0 0 0 0 0 0 0 0 20 20 20 20 0
0 0 0 0 0 7 5 5 1 2 0 0 0 0 0 0 0 0 0 0 0 2 2 2 0 0 0 0 0 0 0 0 0 0 0 0 0 0 0 2 1 2 0 0 0 0 0 0 0 0 0 0 0 0 0 20 3 3 20 0
0 0 0 0 0 7 5 5 1 2 2 2 2 0 0 0 0 2 2 2 2 2 1 2 0 0 0 0 0 0 0 20 20 20 20 0 0 0 0 2 1 2 0 0 0 0 0 0 0 0 0 0 0 0 0 20 3 3 20 0
0 0 0 0 0 7 5 5 1 1 1 1 2 0 0 0 0 2 1 1 1 1 1 2 0 0 0 0 0 0 0 20 3 3 20 0 0 0 0 2 1 2 0 0 0 0 0 0 0 0 0 0 0 0 0 20 20 20 20 0
0 0 0 0 0 7 7 7 7 2 2 2 2 0 0 0 0 2 1 2 2 2 2 2 0 0 0 0 0 0 0 20 3 3 20 0 0 0 0 2 2 2 0 0 0 0 0 0 0 0 0 0 0 0 0 0 0 0 0 0
0 0 0 0 0 0 0 0 0 0 0 0 0 0 0 0 0 2 1 2 0 0 0 0 0 0 0 0 0 0 0 20 20 20 20 0 0 0 0 0 0 0 0 0 0 2 2 2 2 0 0 0 2 2 2 2 0 0 0 0
0 0 0 0 0 0 0 0 0 0 0 0 0 0 0 0 0 2 1 2 0 0 0 0 0 0 0 0 0 0 0 0 0 0 0 0 0 0 0 0 0 0 0 0 0 2 1 1 2 0 0 0 2 1 1 2 0 0 0 0
0 0 0 0 0 0 0 0 0 20 20 20 20 0 0 0 0 2 1 2 0 0 0 0 0 0 0 0 0 0 0 0 0 0 0 0 0 0 0 0 0 0 0 0 0 2 1 2 2 6 6 6 2 2 1 2 0 0 0 0
2 2 2 2 2 2 2 0 0 20 3 3 20 0 0 0 0 2 1 2 0 0 0 0 0 0 0 0 0 0 0 0 0 0 2 2 2 2 2 0 0 0 0 0 0 2 2 2 6 6 4 6 6 2 2 2 0 0 0 0
1 1 1 1 1 1 2 0 0 20 3 3 20 0 0 0 0 2 1 2 0 0 0 0 0 0 0 0 0 0 0 0 0 0 2 1 1 1 2 0 0 0 0 0 0 0 0 0 6 4 4 4 6 0 0 0 0 0 0 0
2 2 2 2 2 1 2 0 0 20 20 20 20 0 0 0 0 2 2 2 0 0 0 0 0 0 0 0 0 0 0 0 0 0 2 2 2 2 2 0 0 0 0 0 0 2 2 2 6 6 4 6 6 2 2 2 0 0 0 0
0 0 0 0 2 1 2 0 0 0 0 0 0 0 0 0 0 0 0 0 0 0 0 0 0 0 20 20 20 20 0 0 0 0 0 0 0 0 0 0 0 0 0 0 0 2 1 2 2 6 6 6 2 2 1 2 0 0 0 0
6 6 0 0 2 2 2 0 0 0 0 0 0 0 0 0 0 0 0 0 0 0 0 0 0 0 20 3 3 20 0 0 0 0 0 0 0 0 0 20 20 20 20 0 0 2 1 1 2 0 0 0 2 1 1 2 0 0 7 7
4 6 6 0 0 0 0 0 0 0 0 0 0 0 0 0 0 0 0 0 0 0 0 0 0 0 20 3 3 20 0 0 0 0 0 0 0 0 0 20 3 3 20 0 0 2 2 2 2 0 0 0 2 2 2 2 0 7 7 5
4 4 6 6 0 0 0 0 0 0 0 0 0 0 0 0 0 0 0 0 0 0 0 0 0 0 20 20 20 20 0 0 0 0 0 0 0 0 0 20 3 3 20 0 0 0 0 0 0 0 0 0 0 0 0 0 7 7 5 5
4 4 4 6 0 0 0 0 0 0 0 0 0 0 0 0 0 0 0 0 0 0 0 0 0 0 0 0 0 0 0 0 0 0 0 0 0 0 0 20 20 20 20 0 0 0 0 0 0 0 0 0 0 0 0 0 7 5 5 5
--2--
# BASES
5 BASE_SPOT 0 99 45 28
5 BASE_SPOT 1 99 4 56
# RADAR STATIONS
5 2882343047 0 99 13 44
5 2882343047 0 99 41 34
# ENERGY GEN
5 RESGEN_ENER 0 99 2 37
5 RESGEN_ENER 0 99 8 2
5 RESGEN_ENER 0 99 7 16
5 RESGEN_ENER 0 99 11 57
5 RESGEN_ENER 0 99 15 30
5 RESGEN_ENER 0 99 23 18
5 RESGEN_ENER 0 99 32 56
5 RESGEN_ENER 0 99 34 25
5 RESGEN_ENER 0 99 37 9
5 RESGEN_ENER 0 99 48 33
5 RESGEN_ENER 0 99 53 11
5 RESGEN_ENER 0 99 58 41
# MATERIAL GEN
5 RESGEN_MAT 0 99 2 10
5 RESGEN_MAT 0 99 6 23
5 RESGEN_MAT 0 99 7 46
5 RESGEN_MAT 0 99 18 9
5 RESGEN_MAT 0 99 24 27
5 RESGEN_MAT 0 99 28 13
5 RESGEN_MAT 0 99 32 36
5 RESGEN_MAT 0 99 18 50
5 RESGEN_MAT 0 99 43 19
5 RESGEN_MAT 0 99 46 57
5 RESGEN_MAT 0 99 57 28
## ROCKS
5 ROCKS 3 99 11 0
5 ROCKS 7 99 12 0
5 ROCKS 8 99 13 0
5 ROCKS 10 99 14 0
5 ROCKS 4 99 14 1
5 ROCKS 5 99 14 2
5 ROCKS 1 99 14 3
5 ROCKS 0 10 5
5 ROCKS 6 99 10 6
5 ROCKS 13 99 10 7
5 ROCKS 7 99 11 7
5 ROCKS 2 99 12 7
5 ROCKS 0 8 5
5 ROCKS 6 99 8 6
5 ROCKS 11 99 8 7
5 ROCKS 9 99 7 7
5 ROCKS 3 99 6 7
5 ROCKS 2 99 3 5
5 ROCKS 9 99 2 5
5 ROCKS 8 99 1 5
5 ROCKS 12 99 0 5
5 ROCKS 5 99 0 6
5 ROCKS 6 99 0 7
5 ROCKS 1 99 0 8
5 ROCKS 0 19 11
5 ROCKS 4 99 19 12
5 ROCKS 5 99 19 13
5 ROCKS 11 99 19 14
5 ROCKS 7 99 18 14
5 ROCKS 9 99 17 14
5 ROCKS 3 99 16 14
5 ROCKS 2 99 12 11
5 ROCKS 8 99 11 11
5 ROCKS 12 99 10 11
5 ROCKS 5 99 10 12
5 ROCKS 1 99 10 13
5 ROCKS 3 99 6 11
5 ROCKS 8 99 7 11
5 ROCKS 10 99 8 11
5 ROCKS 6 99 8 12
5 ROCKS 1 99 8 13
5 ROCKS 0 5 16
5 ROCKS 4 99 5 17
5 ROCKS 5 99 5 18
5 ROCKS 13 99 5 19
5 ROCKS 7 99 6 19
5 ROCKS 8 99 7 19
5 ROCKS 9 99 8 19
5 ROCKS 7 99 9 19
5 ROCKS 8 99 10 19
5 ROCKS 2 99 11 19
# top central
5 ROCKS 0 0 19
5 ROCKS 6 99 0 20
5 ROCKS 5 99 0 21
5 ROCKS 1 99 0 22
# top-right horizontal 
5 ROCKS 3 99 08 29
5 ROCKS 7 99 09 29
5 ROCKS 0 10 27
5 ROCKS 4 99 10 28
5 ROCKS 14 99 10 29
5 ROCKS 6 99 10 30
5 ROCKS 1 99 10 31
# central-left T
5 ROCKS 3 99 17 20
5 ROCKS 7 99 18 20
5 ROCKS 8 99 19 20
5 ROCKS 16 99 20 20
5 ROCKS 9 99 21 20
5 ROCKS 8 99 22 20
5 ROCKS 2 99 23 20
5 ROCKS 0 20 17
5 ROCKS 4 99 20 18
5 ROCKS 5 99 20 19
# central-right T
5 ROCKS 3 99 17 24
5 ROCKS 7 99 18 24
5 ROCKS 8 99 19 24
5 ROCKS 8 99 20 24
5 ROCKS 17 99 21 24
5 ROCKS 9 99 22 24
5 ROCKS 8 99 23 24
5 ROCKS 7 99 24 24
5 ROCKS 2 99 25 24
5 ROCKS 4 99 21 25
5 ROCKS 5 99 21 26
5 ROCKS 6 99 21 27
5 ROCKS 1 99 21 28
# small vertical bottom-right
5 ROCKS 3 99 26 28
5 ROCKS 7 99 27 28
5 ROCKS 2 99 28 28
# bottom central L
5 ROCKS 0 99 31 25
5 ROCKS 6 99 31 26
5 ROCKS 4 99 31 27
5 ROCKS 13 99 31 28
5 ROCKS 7 99 32 28
5 ROCKS 8 99 33 28
5 ROCKS 2 99 34 28
# bottom right T
5 ROCKS 0 99 24 33
5 ROCKS 4 99 24 34
5 ROCKS 3 99 22 35
5 ROCKS 7 99 23 35
5 ROCKS 16 99 24 35
5 ROCKS 8 99 25 35
5 ROCKS 2 99 26 35
# big L on bottom left
5 ROCKS 3 99 24 7
5 ROCKS 7 99 25 7
5 ROCKS 9 99 26 7
5 ROCKS 8 99 27 7
5 ROCKS 9 99 28 7
5 ROCKS 7 99 29 7
5 ROCKS 10 99 30 7
5 ROCKS 4 99 30 8
5 ROCKS 5 99 30 9
5 ROCKS 6 99 30 10
5 ROCKS 4 99 30 11
5 ROCKS 1 99 30 12
# small vertical central-bottom
5 ROCKS 3 99 28 19
5 ROCKS 2 99 29 19
# bottom left long vertical
5 ROCKS 3 99 22 2
5 ROCKS 9 99 23 2
5 ROCKS 8 99 24 2
5 ROCKS 7 99 25 2
5 ROCKS 9 99 26 2
5 ROCKS 9 99 27 2
5 ROCKS 7 99 28 2
5 ROCKS 8 99 29 2
5 ROCKS 9 99 30 2
5 ROCKS 8 99 31 2
5 ROCKS 7 99 32 2
5 ROCKS 10 99 33 2
5 ROCKS 4 99 33 3
5 ROCKS 13 99 33 4
5 ROCKS 9 99 34 4
5 ROCKS 7 99 35 4
5 ROCKS 2 99 36 4
# central top-right
5 ROCKS 3 99 13 35
5 ROCKS 8 99 14 35
5 ROCKS 7 99 15 35
5 ROCKS 2 99 16 35
# top right small corner
5 ROCKS 12 99 5 36
5 ROCKS 1 99 5 37
5 ROCKS 2 99 6 36
# center bottom horizontal
5 ROCKS 0 99 38 14
5 ROCKS 6 99 38 15
5 ROCKS 5 99 38 16
5 ROCKS 4 99 38 17
5 ROCKS 6 99 38 18
5 ROCKS 1 99 38 19
# bottom right small corner
5 ROCKS 3 99 36 33
5 ROCKS 11 99 37 33
5 ROCKS 0 99 37 32
# small top-right
5 ROCKS 3 99 0 45
5 ROCKS 2 99 1 45
# inverted L top-right
5 ROCKS 3 99 9 50
5 ROCKS 8 99 10 50
5 ROCKS 9 99 11 50
5 ROCKS 11 99 12 50
5 ROCKS 0 12 49
# big horizontal central-right
5 ROCKS 3 99 22 44
5 ROCKS 9 99 23 44
5 ROCKS 10 99 24 44
5 ROCKS 4 99 24 45
5 ROCKS 5 99 24 46
5 ROCKS 6 99 24 47
5 ROCKS 13 99 24 48
5 ROCKS 8 99 25 48
5 ROCKS 10 99 26 48
5 ROCKS 6 99 26 49
5 ROCKS 5 99 26 50
5 ROCKS 4 99 26 51
5 ROCKS 6 99 26 52
5 ROCKS 4 99 26 53
5 ROCKS 5 99 26 54
5 ROCKS 6 99 26 55
5 ROCKS 1 99 26 56
# vertical central-right
5 ROCKS 3 99 29 41
5 ROCKS 9 99 30 41
5 ROCKS 8 99 31 41
5 ROCKS 7 99 32 41
5 ROCKS 2 99 33 41
# cross right
5 ROCKS 3 99 34 50
5 ROCKS 7 99 35 50
5 ROCKS 9 99 36 50
5 ROCKS 8 99 37 50
5 ROCKS 18 99 38 50
5 ROCKS 8 99 39 50
5 ROCKS 9 99  50
5 ROCKS 7 99 41 50
5 ROCKS 2 99 42 50
5 ROCKS 0 38 47
5 ROCKS 4 99 38 48
5 ROCKS 5 99 38 49
5 ROCKS 6 99 38 51
5 ROCKS 5 99 38 52
5 ROCKS 1 99 38 53
# upside-down L right
5 ROCKS 0 99 42 39
5 ROCKS 13 99 42 40
5 ROCKS 7 99 43
5 ROCKS 8 99 44
5 ROCKS 9 99 45
5 ROCKS 7 99 46
5 ROCKS 2 99 47
# little horizontal central-bottom
5 ROCKS 0 99 53 35
5 ROCKS 4 99 53 36
5 ROCKS 1 99 53 37
# 4 ROCKS corners bottom-right
5 ROCKS 12 99 50 46
5 ROCKS 1 99 50 47
5 ROCKS 2 99 51 46
5 ROCKS 13 99 50 54
5 ROCKS 0 99 50 53
5 ROCKS 2 99 51 54
5 ROCKS 10 99 56 46
5 ROCKS 1 99 56 47
5 ROCKS 3 99 55 46
5 ROCKS 11 99 56 54
5 ROCKS 0 99 56 53
5 ROCKS 3 99 55 54
# down L bottom-left
5 ROCKS 0 99 53 0
5 ROCKS 4 99 53 1
5 ROCKS 5 99 53 2
5 ROCKS 6 99 53 3
5 ROCKS 5 99 53 4
5 ROCKS 13 99 53 5
5 ROCKS 7 99 54 5
5 ROCKS 2 99 55 5
# L bottom-left
5 ROCKS 3 99 43 8
5 ROCKS 7 99 44 8
5 ROCKS 9 99 45 8
5 ROCKS 8 99 46 8
5 ROCKS 10 99 47 8
5 ROCKS 4 99 47 9
5 ROCKS 5 99 47 10
5 ROCKS 1 99 47 11
# big S next to bottom base
5 ROCKS 3 99 46 22
5 ROCKS 11 99 47 22
5 ROCKS 4 99 47 21
5 ROCKS 5 99 47 20
5 ROCKS 6 99 47 19
5 ROCKS 12 99 47 18
5 ROCKS 7 99 48 18
5 ROCKS 7 99 49 18
5 ROCKS 8 99 50 18
5 ROCKS 8 99 51 18
5 ROCKS 9 99 52 18
5 ROCKS 2 99 53 18
# PRACTICE TARGET
5 TARGET 0 99 54 25
5 TARGET 0 99 49 25
5 TARGET 0 99 49 20
5 TARGET 0 99 54 20
